1 0 0 0 0 0 0 0 0 0 0 0 0 0 0 0 0 0 0 0 0 0 0 0 0 0 0 0 0 0 0 0 0 0 0 3 0 0 0 0 0 0 0 0 0 0 0 0 0 0
1 3 0 0 0 0 0 0 0 0 0 0 0 0 0 0 0 0 0 0 0 0 0 0 0 0 0 0 0 0 0 0 0 0 0 3 0 0 0 0 0 0 0 0 0 0 0 0 0 0
1 0 3 0 0 0 0 0 0 0 0 0 0 0 0 0 0 0 0 0 0 0 0 0 0 0 0 0 0 0 0 0 0 0 0 3 0 0 0 0 0 0 0 0 0 0 0 0 0 0
1 0 0 3 0 0 0 0 0 0 0 0 0 0 0 0 0 0 0 0 0 0 0 0 0 0 0 0 0 0 0 0 0 0 0 3 0 0 0 0 0 0 0 0 0 0 0 0 0 0
1 0 0 0 3 0 0 0 0 0 0 0 0 0 0 0 0 0 0 0 0 0 0 0 0 0 0 0 0 0 0 0 0 0 0 3 0 0 0 0 0 0 0 0 0 0 0 0 0 0
1 0 0 0 0 3 0 2 2 2 2 0 0 0 0 0 0 0 0 0 0 0 0 0 0 0 0 0 0 0 0 0 0 0 0 3 0 0 0 0 0 0 0 4 4 4 0 0 0 0
1 0 0 0 0 0 3 2 2 2 2 0 0 0 0 0 0 0 0 0 0 0 0 0 0 0 0 0 0 0 0 0 0 0 0 3 0 0 0 0 0 0 0 4 4 4 0 0 0 0
1 0 0 0 0 0 0 2 2 2 2 0 0 0 0 0 0 0 0 0 0 0 0 0 0 0 0 0 0 0 0 0 0 0 0 3 0 0 0 0 0 0 0 4 4 4 0 0 0 0
1 0 0 0 0 0 0 2 2 2 2 0 0 0 0 0 0 0 0 0 2 2 2 2 2 2 2 2 2 2 2 0 0 0 0 3 0 0 0 0 0 0 0 4 4 4 0 0 0 0
1 0 0 0 0 0 0 0 2 2 5 5 0 0 0 0 0 0 0 5 5 5 5 2 2 2 2 2 2 2 5 5 0 0 0 3 0 0 0 0 0 0 0 4 4 4 0 0 0 0
1 0 0 0 0 0 0 0 0 2 5 0 0 0 0 0 0 0 5 5 0 0 5 5 5 5 5 5 5 0 0 5 5 0 0 3 0 0 0 0 0 0 0 4 4 4 0 0 0 0
1 0 0 0 0 0 0 0 0 5 5 0 0 0 0 0 0 5 5 0 0 0 0 0 5 5 5 5 0 0 0 0 5 5 0 3 0 0 0 0 0 0 0 4 4 4 0 0 0 0
1 0 0 0 0 0 0 0 0 5 0 0 0 0 0 0 5 5 0 0 0 0 0 0 0 5 5 0 0 0 0 0 0 5 5 3 0 0 0 0 0 0 0 0 0 0 0 0 0 0
1 4 4 4 0 0 0 0 0 5 0 0 0 0 0 5 5 0 0 0 0 0 0 0 0 0 5 5 0 0 0 0 0 0 5 3 0 0 0 0 0 0 0 0 0 0 0 0 0 0
1 4 4 4 0 0 0 0 0 5 0 0 0 0 5 5 0 0 0 0 5 5 5 5 5 0 0 5 5 0 0 0 0 0 5 3 0 0 0 0 0 0 0 0 0 0 0 0 0 0
1 4 4 4 0 0 0 0 0 5 0 0 0 5 5 0 0 0 0 5 5 2 2 2 5 5 0 0 5 5 0 0 0 0 5 3 0 0 0 0 0 0 0 0 0 0 0 0 0 0
1 0 0 0 0 0 0 0 0 5 0 0 5 5 0 0 0 0 5 5 5 2 2 2 5 5 5 0 0 5 5 0 0 0 5 3 0 0 0 0 0 0 0 0 0 0 0 0 0 0
1 0 0 0 0 0 0 0 0 5 0 5 5 0 0 0 0 5 5 5 5 2 2 2 5 5 5 5 0 0 5 5 0 0 5 3 0 0 0 0 0 0 0 0 0 0 0 0 0 0
1 0 0 0 0 0 0 0 0 5 5 5 0 0 0 0 5 5 5 5 5 2 2 2 5 5 5 5 5 0 0 5 5 0 5 3 0 0 0 0 0 0 0 0 0 0 0 0 0 0
1 0 0 0 0 0 0 0 0 0 5 0 0 0 0 5 5 5 5 5 5 2 2 2 5 5 5 5 5 5 0 0 5 5 5 3 0 0 0 0 0 0 0 0 0 0 0 0 0 0
1 0 0 0 0 0 0 0 0 0 0 0 0 0 5 5 5 5 5 5 5 5 2 2 5 5 5 5 5 5 5 0 0 5 5 3 0 0 0 0 0 0 0 0 0 0 0 0 0 0
1 0 0 0 0 0 0 0 0 0 0 0 0 5 5 5 5 5 5 5 5 5 2 2 5 5 5 5 5 5 5 5 0 0 5 3 0 0 0 0 0 0 0 0 0 0 0 0 0 0
1 0 0 0 0 0 0 0 0 0 0 0 5 5 5 5 5 5 5 5 5 5 2 2 5 5 5 5 5 5 5 5 5 0 5 3 0 0 0 0 0 0 0 0 0 0 0 0 0 0
1 0 0 0 0 0 0 0 0 0 0 5 5 5 5 5 5 5 5 5 5 5 2 2 5 5 5 5 5 5 5 5 5 5 5 3 0 0 0 0 0 0 0 0 0 0 0 0 0 0
1 0 0 0 0 0 0 0 0 0 5 5 5 5 5 5 5 5 5 5 5 5 2 2 5 5 5 5 5 5 5 5 5 5 5 3 0 0 0 0 0 0 0 0 0 0 0 0 0 0
1 0 0 0 0 0 0 0 0 5 5 4 4 4 5 5 5 5 5 5 5 5 2 2 5 5 5 5 5 5 5 5 5 5 5 3 0 0 0 0 0 0 0 0 0 0 0 0 0 0
1 0 0 0 0 0 0 0 5 5 4 4 4 4 4 5 5 5 1 5 5 5 2 2 5 5 5 5 5 5 5 5 5 5 5 3 0 0 0 0 0 0 0 0 0 0 0 0 0 0
1 0 0 0 0 0 0 5 5 4 4 4 4 4 4 5 5 5 5 5 5 5 2 2 5 5 5 5 5 5 5 5 5 5 5 3 0 0 0 0 0 0 0 0 0 0 0 0 0 0
1 0 0 0 0 0 5 5 4 4 4 4 4 4 4 5 5 5 5 5 5 5 2 2 5 5 5 5 5 5 5 5 5 5 5 3 0 0 0 0 0 0 0 0 0 0 0 0 0 0
1 0 0 0 0 5 5 4 4 4 4 4 4 4 4 5 5 5 5 5 5 5 2 2 5 5 5 5 5 5 5 5 5 5 5 3 0 0 0 0 0 0 0 0 0 0 0 0 0 0
1 0 0 0 5 5 4 4 4 4 4 4 4 4 4 5 5 5 5 5 5 5 2 2 5 5 5 5 5 5 5 5 5 5 5 3 0 0 0 0 0 0 0 0 0 0 0 0 0 0
1 0 0 5 5 4 4 4 4 4 4 4 4 4 4 5 5 5 5 5 5 5 2 2 5 5 5 5 5 5 5 5 5 5 5 3 3 3 3 3 3 3 3 3 3 3 3 3 3 3
1 0 5 5 4 4 4 4 4 4 4 4 4 4 4 5 5 5 5 5 5 5 2 2 5 5 5 5 5 5 5 5 5 5 5 3 0 0 0 0 0 0 0 0 0 0 0 0 0 0
1 5 5 4 4 4 4 4 4 4 4 4 4 4 4 5 5 5 5 5 5 5 2 2 5 5 5 5 5 5 5 5 5 5 5 3 0 0 0 0 0 0 0 0 0 0 0 0 0 0
1 0 5 5 4 4 4 4 4 4 4 4 4 4 4 5 5 5 5 5 5 5 2 2 5 5 5 5 5 5 5 5 5 5 5 3 0 0 0 0 0 0 0 0 0 0 0 0 0 0
1 0 0 5 5 4 4 4 4 4 4 4 4 4 4 5 5 5 5 5 5 5 2 2 5 5 5 5 5 5 5 5 5 5 5 3 0 0 0 0 0 0 0 0 0 0 0 0 0 0
1 0 0 0 5 5 4 4 4 4 4 4 4 4 4 5 5 5 5 5 5 5 2 2 5 5 5 5 5 5 5 5 5 5 5 3 0 0 0 0 0 0 0 0 0 0 0 0 0 0
1 0 0 0 0 5 5 4 4 4 4 4 4 4 4 5 5 5 5 5 5 5 2 2 5 5 5 5 5 5 5 5 5 5 5 3 0 0 0 0 0 0 0 0 0 0 0 0 0 0
1 0 0 0 0 0 5 5 4 4 4 4 4 4 4 5 5 5 5 5 5 5 2 2 5 5 5 5 5 5 5 5 5 5 5 3 0 0 0 0 0 0 0 0 0 0 0 0 0 0
1 0 0 0 0 0 0 5 5 4 4 4 4 4 4 5 5 5 5 5 5 5 2 2 5 5 5 5 5 5 5 5 5 5 5 3 0 0 0 0 0 0 0 0 0 0 0 0 0 0
1 0 0 0 0 0 0 0 5 5 4 4 4 4 4 5 5 5 5 5 5 5 2 2 5 5 5 5 5 5 5 5 5 5 5 3 0 0 0 0 0 0 0 0 0 0 0 0 0 0
1 0 0 0 0 0 0 0 0 5 5 4 4 4 4 5 5 5 5 5 5 5 2 2 5 5 5 5 5 5 5 5 5 5 5 3 0 0 0 0 0 0 0 0 0 0 0 0 0 0
1 0 0 0 0 0 0 0 0 0 5 5 4 4 4 5 5 5 5 5 5 5 2 2 5 5 5 5 5 5 5 5 5 5 5 3 0 0 0 0 0 0 0 0 0 0 0 0 0 0
1 0 0 0 0 0 0 0 0 0 0 5 5 4 4 5 5 5 5 5 5 5 2 2 5 5 5 5 5 5 5 5 5 5 5 3 0 0 0 0 0 0 0 0 0 0 0 0 0 0
1 0 0 0 0 0 0 0 0 0 0 0 5 5 4 5 5 5 5 5 5 5 2 2 5 5 5 5 5 5 5 5 5 5 5 3 0 0 0 0 0 0 0 0 0 0 0 0 0 0
1 0 0 0 0 0 0 0 0 0 0 0 0 5 5 5 5 5 5 5 5 5 2 2 5 5 5 5 5 5 5 5 5 5 5 3 0 0 0 0 0 0 0 0 0 0 0 0 0 0
1 0 0 0 0 0 0 0 0 0 0 0 0 0 5 5 5 5 5 5 5 5 2 2 5 5 5 5 5 5 5 5 5 5 5 3 0 0 0 0 0 0 0 0 0 0 0 0 0 0
1 0 0 0 0 0 0 0 0 0 0 0 0 0 0 5 5 5 5 5 5 5 2 2 5 5 5 5 5 5 5 5 5 5 5 3 0 0 0 0 0 0 0 0 0 0 0 0 0 0
1 0 0 0 0 0 0 0 0 0 0 0 0 0 0 0 5 5 5 5 5 5 2 2 5 5 5 5 5 5 5 5 5 5 5 3 0 0 0 0 0 0 0 0 0 0 0 0 0 0
1 0 0 0 0 0 0 0 0 0 0 0 0 0 0 0 0 5 5 5 5 5 2 2 5 5 5 5 5 5 5 5 5 5 5 3 0 0 0 0 0 0 0 0 0 0 0 0 0 0
1 0 0 0 0 0 0 0 0 0 0 0 0 0 0 0 0 0 5 5 5 5 2 2 5 5 5 5 5 5 5 5 5 5 5 3 0 0 0 0 0 0 0 0 0 0 0 0 0 0
1 0 0 0 0 0 0 0 0 0 0 0 0 0 0 0 0 0 0 5 5 5 2 2 5 5 5 5 5 5 5 5 5 5 5 3 0 0 0 0 0 0 0 0 0 0 0 0 0 0
1 0 0 0 0 0 0 0 0 0 0 0 0 0 0 0 0 0 0 0 5 5 2 2 5 5 5 5 5 5 5 5 5 5 5 3 0 0 0 0 0 0 0 0 0 0 0 0 0 0
1 0 0 0 0 0 0 0 0 0 0 0 0 0 0 0 0 0 0 0 0 5 2 2 5 5 5 5 5 5 5 5 5 5 5 3 0 0 0 0 0 0 0 0 0 0 0 0 0 0